8,8,8,8,8,8,8,8,0,0,0,0,7,7,7,7,7,8,7,7,8,8,8,7,7
8,8,8,8,8,7,0,0,0,0,0,0,0,7,7,7,7,7,7,0,0,0,8,8,8
8,8,7,7,0,0,0,0,0,0,0,0,0,0,0,7,7,7,0,0,0,0,0,8,8
8,7,0,0,0,0,0,0,0,0,0,0,0,0,0,0,0,0,0,0,0,0,0,0,8
7,0,0,0,0,0,0,0,0,0,0,0,0,0,0,0,0,0,0,0,0,0,0,0,8
0,0,0,0,0,0,0,0,0,0,0,0,0,0,0,0,0,0,0,0,0,0,0,0,8
0,0,0,0,0,0,0,0,0,0,0,0,0,0,0,0,0,0,0,0,0,0,0,7,8
0,0,0,0,0,0,0,0,0,0,0,0,0,0,0,0,0,0,0,0,0,0,0,7,8
0,0,10,10,10,0,0,0,0,0,0,0,0,0,0,0,0,0,0,0,0,0,0,8,8
0,0,0,0,0,0,0,0,0,0,0,0,0,0,0,0,0,0,0,0,0,0,0,8,8
0,0,0,0,0,0,0,0,0,0,0,0,0,0,0,0,0,0,0,0,0,0,7,8,8
0,0,0,7,7,7,0,0,0,0,0,0,0,0,0,0,0,0,0,0,0,0,8,8,8
8,8,8,8,8,8,7,0,7,0,0,0,0,0,0,0,0,0,0,7,7,8,8,8,0
8,8,8,8,8,8,8,8,8,8,8,8,8,8,8,8,8,8,8,8,8,8,8,0,0
